{
  "Name": "One",
  "Controls": "WASD/Arrow keys: Move   Z: Undo   R: Restart   Esc/L: Leave",
  "Base": [0, 0, 0],
  "Size": [12, 8, 2],
  "Map": [
    1, 1, 1, 1, 1, 1, 1, 1, 1, 1, 1, 1,
    1, 1, 1, 1, 1, 1, 1, 1, 1, 1, 1, 1,
    1, 1, 0, 0, 0, 1, 1, 0, 0, 0, 1, 1,
    1, 1, 1, 1, 1, 1, 1, 1, 1, 1, 1, 1,
    1, 1, 1, 1, 1, 1, 1, 1, 1, 1, 1, 1,
    1, 1, 0, 0, 0, 1, 1, 0, 0, 0, 1, 1,
    1, 1, 1, 1, 1, 1, 1, 1, 1, 1, 1, 1,
    1, 1, 1, 1, 1, 1, 1, 1, 1, 1, 1, 1,

    1, 1, 1, 1, 1, 1, 1, 1, 1, 1, 1, 1,
    1, 0, 0, 0, 0, 0, 0, 0, 0, 0, 0, 1,
    1, 0, 0, 0, 0, 0, 0, 0, 0, 0, 0, 1,
    1, 0, 0, 0, 0, 0, 0, 0, 0, 0, 0, 1,
    1, 0, 0, 0, 0, 0, 0, 0, 0, 0, 0, 1,
    1, 0, 0, 0, 0, 0, 0, 0, 0, 0, 0, 1,
    1, 0, 0, 0, 0, 0, 0, 0, 0, 0, 0, 1,
    1, 1, 1, 1, 1, 1, 1, 1, 1, 1, 1, 1
  ],
  "Entities": [
    {
      "Position": [3, 3, 1],
      "Direction": [0, 1, 0],
      "Gravity": [0, 0, -1],
      "CounterValue": null,
      "CustomData": {
        "$Type": "Player"
      }
    }
  ]
}