{
  "Name": "Test",
  "Controls": "",
  "Base": [0, 0, 0],
  "Size": [10, 7, 2],
  "SublevelPaths": [],
  "Map": [
      1, 1, 1, 1, 1, 0, 3, 4, 4, 4,
      1, 1, 1, 1, 1, 2, 3, 3, 4, 4,
      1, 1, 1, 1, 2, 2, 3, 3, 3, 4,
      1, 1, 1, 1, 2, 2, 3, 3, 4, 4,
      0, 2, 2, 2, 2, 2, 3, 3, 4, 4,
      0, 2, 2, 5, 1, 1, 3, 4, 4, 4,
      0, 2, 2, 1, 1, 1, 4, 4, 4, 4,

      0, 0, 0, 0, 0, 1, 0, 0, 0, 0,
      0, 0, 0, 0, 0, 0, 0, 0, 0, 0,
      0, 0, 0, 0, 0, 0, 0, 0, 0, 0,
      0, 0, 0, 0, 0, 0, 0, 0, 0, 0,
      0, 0, 0, 0, 0, 0, 0, 0, 0, 0,
      0, 0, 0, 0, 0, 0, 0, 0, 0, 0,
      0, 0, 0, 0, 0, 0, 0, 0, 0, 0
    ],
  "Entities": [
    {
      "Position": [3, 3, 1],
      "Direction": [0, 1, 0],
      "Gravity": [0, 0, -1],
      "CustomData": {
        "$Type": "Player"
      }
    }
  ]
}